12345678901234567890
11111111111111111111
1                  1
1                  1
1                  E
1                  E
1  11111111111111111
1        1         1
1        1         1
1        1         1
1111111  1         1
1        1         1
1        1         1
1        1         1
1        1         1
1        1         1
1        1         1
1                  1
1                  1
1                  1
11111111EE1111111111