12345678901234567890
11111111EE1111111111
1                  1
1             S    1
1                  1
1                  1
1           11111111
1     S     1      1
1           1      1
1            1     1
1            1     1
1            1     1
1            11111 1
1                  1
1                  1
1                  1
1                  1
111111111     1    1
1       1     1    1
1  Z          1    1
11111111111111111111