12345678901234567890
1111111111111111EE11
E                  1
E                  1
1                  1
1                  1
1    11      11    1
1    11      11    1
1                  1
1        11        1
1                  1
1    11      11    1
1    11      11    1
1                  1
1        11        1
1                  1
1    11      11    1
1    11      11    1
1                S 1
1                  1
11111111111111111111