12345678901234567890
1111111EEE1111111111
1     1            1
1     1            1
1     1            1
1     1            1
1     1            1
1     1            1
1     1            1
1     1            1
1     1            1
1     1            1
E     1            1
E     1            1
1     1            1
1     1            1
1     1            1
1     11111111111  1
1     1            1
1                  1
11111111111111111111