12345678901234567890
1111EE11111111111111
1        1         1
1        1         1
1        1         1
1   11   1         1
1   11   1         1
1        1         1
1        1         1
1        11111111  1
1                  1
1                  1
1  1111111         1
1        1         1
1        1    11   1
1        1    11   1
1        1         1
1        1         1
1        1         1
1        1         1
1111111111111111EE11