12345678901234567890
11111111111111111111
E                  1
E                  1
1                  1
1                  1
1    11      11    1
1    11      11    1
1                  1
1        11        1
1                  1
1    11      11    1
1    11      11    1
1                  1
1        11        1
1                  1
1    11      11    1
1    11      11    1
1                  1
1                  1
11111111EE1111111111