12345678901234567890
11111111111111111111
1    S             1
1111111111111111   1
11111111111111111  1
11111111111111111  1
1111111            1
1        11111111111
1        11111111111
1  SS    11111111111
1  SS    11111111111
1        11111111111
1        11111111111
1        11111111111
111111   11111111111
11111   111111111111
1111   1111111111111
1111  11111111111111
1111  11111111111111
1111  11111111111111
1111EE11111111111111