12345678901234567890
11111111111111111111
1      1           1
1      1       1   1
1      1       1   1
1      1       1   1
111 1111       1   1
1              1   1
1              1   1
1              1   1
1              1   1
1              1   1
1              1   E
1              1   E
1   1111111111111111
1                  1
1                  1
1                  1
1                  1
1                  1
1EEEE111111111111111